xxxxxxxx.xxxxxxxx
x...............x
x.xx.xxxxxxx.xx.x
x.x...........x.x
x.x.xxxx.xxxx.x.x
x.x.x.......x.x.x
x.x.x.xx.xx.x.x.x
x.x.x.x...x.x.x.x
x...x...x...x...x
x.x.x.x...x.x.x.x
x.x.x.xx.xx.x.x.x
x.x.x.......x.x.x
x.x.xxxx.xxxx.x.x
x.x...........x.x
x.xx.xxxxxxx.xx.x
x...............x
xxxxxxxx.xxxxxxxx