xxxxxxxxxxxxxxxxx
x.x........x..x.x
x.x.x.xxxx.x.xx.x
x.x.x....x......x
x.x.xxxx.xxxxxx.x
x...x.x.....x.x.x
xxxxx.xxxxx.x.x.x
x.x.x.x...x.x.x.x
x...x...x...x...x
x.x.x.x...x.x.x.x
x.x.x.xxxxx.x.x.x
x.x.x.......x.x.x
x.x.xxxx.xxxx.x.x
x.x...........x.x
x.xx.xxxxxxx.xx.x
x...............x
xxxxxxxxxxxxxxxxx